NO textures/cute.xpm
SO textures/machiin1.xpm
WE textures/cute2.xpm
EA textures/cute1.xpm

F 164,169,20
C 153,204,30

111111111
101111011
11000111
110N00111
101111011
111111111
